11111111111
1P1C1C1C1E1
10CC000CC01
100C000C001
11111111111
