111111111
1C10001P1
101010101
100010001
111111111
