11111111111
111000001111
11000P00011
1000C0E0001
11000000011
11100000111
11111111111
