1111111111111
101C0C1C0C1E1
1010101010101
1P0C1C0C1C0C1
1111111111111
