1111111111111111
1P10C010C0C0C0C1
1C1C1C1C11111101
1010101010C0E1C1
1C1C1C1C1C111101
10C010C010C0C0C1
1111111111111111
