1111111111111111
1P1C00100C0C0C01
10101C1C11111101
1C1C101010C0C0C1
10101C1C10111111
1C0C1C0010C0CCE1
1111111111111111
