11111111111111
1P000000000001
11111111111101
10CCCCCC00E101
10111111111101
10000000000001
11111111111111
