111111111111111
10C000000000C01
10CC0000000CC01
1ECCC00P00CCCE1
10CC0000000CC01
10C000000000C01
111111111111111
