1111111111111111
1P000000000000C1
1011111C11111101
1011111C11111101
1C000010100000C1
1111111E11111111
1111111111111111
